111,112,111,111,111,111,111,111,111,111,111,111,111,111,111,111,111,111,111,111,111,111,111,111,111,111,111,111,111,111,111,111,111,111,111,111,111,111,112,114
112,0,0,0,0,0,0,0,0,0,0,0,0,0,0,0,0,0,0,0,0,0,0,0,0,0,0,0,0,0,0,0,0,0,0,0,0,0,0,114
112,0,0,0,0,0,0,0,0,0,0,0,0,0,0,0,0,0,0,0,0,0,0,0,0,0,0,0,0,0,0,0,0,0,0,0,0,0,0,114
112,0,0,0,0,0,0,0,0,0,0,0,0,0,0,0,0,0,0,0,0,0,0,0,0,0,0,0,0,0,0,0,0,0,0,0,0,0,0,114
112,111,111,111,0,0,0,0,0,0,0,0,0,0,0,0,0,0,0,111,111,0,0,0,0,0,0,0,0,0,0,0,0,0,0,111,111,111,111,114
111,111,111,111,0,111,111,111,111,111,0,0,0,3,3,3,111,111,111,111,111,111,0,0,0,2,2,2,2,0,0,0,0,0,111,111,111,111,112,114
111,111,111,111,0,111,0,0,0,0,111,111,111,111,111,111,111,0,0,0,0,0,0,0,111,111,111,111,111,111,0,0,0,111,111,111,111,111,112,114
112,0,0,0,0,0,0,0,0,0,0,0,0,0,0,0,0,0,0,0,0,0,0,0,0,0,0,0,0,0,0,0,0,0,0,0,0,0,0,114
112,0,0,0,0,0,0,0,0,0,0,0,0,0,0,0,0,0,0,0,0,0,0,0,0,0,0,0,0,0,0,0,0,0,0,0,0,0,0,114
112,0,0,0,0,0,0,0,0,0,0,0,0,0,0,0,0,0,0,0,0,0,0,0,0,0,0,0,0,0,0,0,0,0,0,0,0,0,0,114
112,0,0,0,0,0,0,111,111,111,111,111,0,0,0,0,0,0,0,0,0,0,0,0,0,111,111,111,111,111,0,0,0,0,0,0,0,0,0,114
112,0,0,0,0,0,111,111,111,111,111,111,111,0,0,0,0,0,0,0,0,0,0,0,111,111,111,111,111,111,111,0,0,0,0,0,0,0,0,114
112,0,0,0,0,0,0,0,0,0,0,0,0,0,0,0,0,0,0,0,0,0,0,0,0,0,0,0,0,0,0,0,0,0,0,0,0,0,0,114
112,0,0,0,4,4,4,0,0,0,0,0,0,0,0,0,0,0,0,0,0,0,0,0,0,0,0,0,0,0,0,0,0,0,0,0,0,0,0,114
112,111,111,111,111,111,111,111,111,111,111,111,111,111,111,0,0,0,0,111,111,111,111,111,111,111,0,0,0,111,111,111,111,111,111,111,111,111,111,114
111,111,0,0,0,0,0,0,0,0,0,0,0,0,0,0,0,111,111,111,111,111,111,0,0,0,0,0,0,0,0,0,0,0,0,0,111,111,114
111,111,111,111,0,0,0,0,0,0,0,0,0,0,0,0,0,0,0,0,0,0,0,0,0,0,0,0,0,0,0,0,0,0,0,111,111,111,112,114
111,111,111,112,0,0,0,0,0,0,0,0,0,0,0,0,0,0,0,0,0,0,0,0,0,0,0,0,0,0,0,0,0,0,0,111,111,111,111,114
111,112,112,112,0,0,0,0,0,0,2,2,2,0,0,0,0,0,0,0,0,0,0,0,0,0,0,0,0,0,0,0,0,0,0,112,112,112,111,114
112,0,0,0,0,0,0,0,0,111,111,111,111,111,0,0,0,0,0,0,0,0,0,0,111,111,111,111,111,0,0,0,0,0,0,0,0,0,0,114
112,0,0,0,0,0,0,0,0,0,0,0,0,0,0,0,0,0,0,0,0,0,0,0,0,0,0,0,0,0,0,0,0,0,0,0,0,0,0,114
112,0,0,0,0,0,0,0,0,0,0,0,0,0,0,0,0,111,111,111,111,111,3,3,3,0,0,0,0,0,0,0,0,0,0,0,0,0,0,114
112,0,0,0,111,111,111,111,0,0,0,0,0,0,111,111,111,111,111,111,111,111,111,111,111,0,0,0,0,111,111,111,111,0,0,0,0,0,0,114
111,0,0,0,0,0,0,0,0,0,0,0,0,0,0,0,0,0,0,0,0,0,0,0,0,0,0,0,0,0,0,0,111,0,0,0,0,0,0,114
111,111,0,0,0,0,0,0,0,2,2,2,2,0,0,0,0,0,0,0,0,0,0,0,0,0,4,4,4,4,0,0,111,111,0,0,0,0,111,114
111,111,111,0,0,0,0,0,111,111,111,111,111,111,111,111,0,0,0,0,0,0,0,0,111,111,111,111,111,111,0,0,0,0,0,0,0,111,111,114
112,0,0,0,0,0,0,0,0,0,0,0,0,0,0,0,0,0,0,0,0,0,0,0,0,0,0,0,0,0,0,0,0,0,0,0,0,111,112,114
112,0,0,0,0,0,0,0,0,0,0,0,0,0,0,0,0,0,111,112,112,111,0,0,0,0,0,0,0,0,0,0,0,0,0,0,0,0,111,112,114
112,0,0,0,0,0,0,0,0,0,0,3,3,3,3,0,0,0,111,112,112,111,2,2,2,2,0,0,0,0,0,0,0,0,0,0,0,0,111,112,114
111,112,111,111,111,111,111,111,111,111,111,111,111,111,111,111,111,111,111,111,111,111,111,111,111,111,111,111,111,111,111,111,111,111,111,111,111,111,112,114
111,112,112,112,112,112,112,112,112,112,112,112,112,112,112,112,112,112,112,112,112,112,112,112,112,112,112,112,112,112,112,112,112,112,112,112,112,112,112,114
